10
10
1111000000
1100000001
1010000001
1000000011
0000000111
0000011111
0000110001
0000111011
0111111011
1111111111