10
10
0000001000
0000011100
0000001000
0000001000
0000001000
1111111100
1000001010
1000001010
1000010001
1111111111