5
5
11111
10001
10001
11011
11011