10
10
0001000100
0011100111
0111110101
1111111100
1111111100
1011111000
1001110000
0001010000
0001010000
0001010000
