15
15
111000000001100
111000000011110
111000000111111
000000000111111
000000001111111
000000011111111
000000011111111
000000011111111
000000010111111
111000000001100
111000100001100
010001110001100
010000100001100
111100100111111
111111111111111
