10
10
0111000000
0111000000
0111000100
0000000100
0000010100
0100011100
0110000101
1100000111
0100000100
1111111111
