15
15
000100001000000
001110011100000
001111111100000
011111111110000
011011101110000
111111111100011
111011011100011
011100111111110
001111111111100
001111111111100
001111111111100
001111111111110
001111111111110
000101110110110
000110110110010