5
5
11011
10101
10101
10001
10001