
15
15
000000100000000
000001010000000
000010000000000
001111110000000
001000010000000
001000010000010
001000010000100
001000010001000
001000010111110
001000010100010
001000010100010
001000010100010
001000010100010
001000010100010
001000010100010