20
20
00000000001000000000
00000000010100000000
00000000100010000000
00000001000001000000
00000010000000100000
00000100000000010000
00001000000000001000
00010000000000000100
00100000000000000010
11111111111111111111
11111111111111111111
11000000000000000011
11000000000000000011
11000000000000000011
11000000000000000011
11000000000000000011
11000000000000000011
11000000000000000011
11111111111111111111
11111111111111111111
