10
10
0000110000
0001111000
0011001100
0110000110
1111111111
1000000001
1011000001
1011001101
1000001101
1111111111