10
10
1110000000
1110000000
1110000000
0000001000
0000011100
0000011111
1111101010
0000101010
0001001001
0001111111
