10
10
0000110000
0000110000
1111111111
0111111110
0011111100
0001111000
0001111000
0011111100
0110001110
1100000011
