15
15
000001111100000
000011000110000
000100111000100
000100111001000
000011000110000
000001111100000
000000010000000
000000110000000
000000011110000
000000010001000
000000011110000
000011110000000
000100011000000
000011110000000
000000010000000