10
10
0110000110
1001111001
0111111110
0011111100
0110110110
1110110111
1111111111
1001111001
0100000010
0011111100