10
10
0111111110
1111111111
1111111111
1001000010
1001000110
1101011000
0011110000
0011110000
0001110000
0001110000
