10
10
0000110000
0000110000
0000110000
0000110000
0001001000
0001001000
0010100100
0010010100
0100100010
1111111111