10
10
0000110000
0000110000
0000110000
0000110000
0000110000
0000110000
0000110000
0001111000
0011001100
1110000111