20
20
11000000000000000011
11100000000000000011
11010000000000000011
11001000000000000011
11000100000000000011
11000010000000000011
11000001000000000011
11000000100000000011
11000000010000000011
11000000001000000011
11000000000100000011
11000000000010000011
11000000000001000011
11000000000000100011
11000000000000010011
11000000000000001011
11000000000000000111
11111111111111111111
11111111111111111111
11111111111111111111
