20
20
00000000000111100000
00000000000111100000
00000000000111100000
00000000000111100000
01111000001111000000
01111000000011110000
01111000000011110000
01111000000111100000
00001111111100000000
00001111111100000000
00001111111100000000
00001111111100000000
00001111111100000000
00011111111000000000
00000111110000000000
00000111110000000000
00000111110000000000
00000111100000000000
11111111111111111111
11111111111111111111