10
10
0000011000
0000111100
0000111100
0001111110
0001011010
0000011000
1110011000
1110011000
0100011000
1111111111