20
20
00000100000000111111
00001000000000011111
00010000000000001111
01111110000100000111
01000010000000000011
01000010000000000000
01000010000000000000
01000010000000010000
01000010000000100000
01000010000001000000
01000010000010000000
01000010011111111000
01000010010000001000
01000010010000001000
01000010010000001000
01000010010000001000
01000010010000001000
01000010010000001000
01000010010000001000
01000010010000001000