
20
20
11111111110000000000
11111111100000000000
11111111000000000000
11111110000000000000
11111100000000000000
11111000000000000000
11110000000000000000
11100000000000000000
11000000000000000000
10000000000000000001
00000000000000000011
00000000000000000111
00000000000000001111
00000000000000011111
00000000000000111111
00000000000001111111
00000000000011111111
00000000000111111111
00000000001111111111
00000000011111111111
