15
15
000011111110000
011111111111110
111110111011111
111110111011111
111111111111111
111111111111111
011111111111110
000011111110000
011100111001110
111110111011111
111111111111111
111111111111111
011111111111110
001111111111100
000011111110000