10
10
0000110000
0000110000
0001111000
0001001000
0011111100
0010000100
0111111110
0100000010
1111111111
1000000001
