10
10
1111111111
0111111011
0000111011
0000110001
0000011111
0000000111
1000000011
1010000001
1100000001
1111000000