15
15
000100010001000
001110111011100
011111111111110
111001111100111
110110111011011
111111111111111
011111111111110
001111111111100
000111111111000
000011111110000
000111000111000
001001000100100
010000101000010
100000111000001
011111000111110