10
10
0000000000
0000000000
0011100000
0110010000
1100000001
0110101010
0011111110
0000101010
0000000001
0000000000
