10
10
1111100000
1000100000
1000100000
1001100000
1001000011
1001000101
1001000101
1001001101
1001001001
1111011111