10
10
0000000000
0000000111
0000000111
0000000101
0000000111
0000000111
0000000101
0100110111
1010110111
1111111111