10
10
0011001100
0101001010
1001001001
1001001001
0101001010
0011001100
0100000010
1001001001
1000000001
0111111110