10
10
1111111100
1111111000
1111110001
1111100011
1111000111
1110001111
1100011111
1000111111
0001111111
0011111111