10
10
0001111000
0011111100
0011111100
0001111000
0000000010
0000001010
0010001110
1011000011
1110010011
0010010010
