10
10
0000011000
0000011000
0100011000
0110011100
0011111000
0001100000
0001110000
0011100000
0001100000
1111111111