10
10
1111110111
0111110111
0111110111
1100011111
1000001111
0000000111
1000001101
1100011011
1111111111
1011101111