10
10
0000001000
0000010100
0000100000
0011111100
0010000100
0010000100
0010000100
0010000100
0010000100
0010000100